15 15
###############
#             #
#   #     #   #
#   #     #   #
#   #  $  #   #
#   #     #   #
#   #     #   #
#      *      #
#   #     #   #
#   #     #   #
#   #     #   #
#   #     #   #
#   #     #   #
#             #
###############
